0000000000000000000000000000000000000000000000000000000000000000000000000000
0000000000000000000000000000000000000000000000000000000000000000000000000000
0000000000000000000000000000000000000000000000000000000000000000000000000000
0000000000000000000000000000000000000000000000000000000000000000000000000000
0000000000000000000000000000000000000000000000000000000000000000000000000000
0000000000000000000000000000000000000000000000000000000000000000000000000000
0000000000000000000000000000000000000000000000000000000000000000000000000000
0000000000000000000000000000000000000000000000000000000000000000000000000000
0000000000000000000000000000000000000000000000000000000000000000000000000000
00000000000000000000000000000000011CCC01000100000000000100000000000000000000
000001100000000000000000000000001011S101110100000000000100000110000000000000
0000011000000000000000000000000010111111110100000000000100000110PP0011000000
00000110000000100PP011000PP0000011111111110001100000000100000111110011000000
01111110PP0000100011111111111111111111111111J1110PP0110000000100000000001100
01111010111111110C1111111100000000011100000001111111100000000100000000001100
0111101111111111111111111100000000011100000001110000000000000100000000001100
0111111110011111111100000000000000011100000001110000000000000100000000001100
011110000000110000110000000000000P1111100000P111000000000P000100000000001100
0011100000000000001100000001000111111110011111110PP000011100010PP010PP001100
001100000000000000111PP00111000000011111100101111111111111111111111111111100
001100000P100000001111100110000000010001100001111111111111111111111111111100
00110000011000000011011110000000000100011000011111111111J1111111111111111100
0011000001111100001100000000000000010001100000000000001111000000001100000000
0111000001000000001100000000000PP00100011PP000000000001111000000001100000000
01110000010000000011P0000000111111111100111000000000001111000000001100000000
00110000010000001111P0000000000000111100100000000000001111000111111111111100
00110000010000P0111110000000000000111100000000000000001111000111111111111100
00110P0001001111111110000000000000111100000000000000001111000000001100001100
0011111111111111111000000000000000011100P0000000000P011111001100000000001100
0000000000000011J11000000000000000011101100000000001111111001100000000001100
0011100000000011111000000000000000011111110000000001111111001100000000001100
00111000000111111110000000000P0000011111110000000001111111001100000000001100
00111000000110011111PP0011111111111J11111111111110000011110011000PP000001100
0011100000PP0001111111111100000000000000000111111111101111111111111001111100
0011110000110001111000000000000000000000000011111111111111001111111111111100
001111000011000111100000000000000000000000000000011J111111000000000000000000
0000000000000001111000000000000000000000000000000000001111000000000000000000
0000000000000001111000000000000000000000000000000000001111000000000000000000
0000000000000001111000000000000000000000000000000000001111000000000000000000
00000000000000011110000000000PPP00000000000000000000001111000000000000000000
0000000000000001111000000000111111100000000000000000001111000000000000000000
0000000000000001111000000000111111100000001110000000001111000000000000000000
00000000000000011110000000001111111000P000111000000000111100000000000000PP00
000000000000000111100000000011111111001100111000000000111100000000000J111100
0000000000000001111000000000000011111111111100000000000111000000000011111000
0000000000000001111000000000000011111111110000000000000111000000000011000000
0000000000000001111000000000000001100110110000000000000111000P0PP00011000000
000000000000PP011110000000000000011001100000000000PP000111000111000011000000
0000000000011111111000000000000001100110000000000111111111000111000011000000
00000000000111J11110000000000P0001100J10000000000111111111000111000011000000
0000000000011111111100J111J111111100110000000000111011111111111011111000000
00000000000111111111111111111111111001100000000P01111111111111111111110P0000
0000000000111111111111111111111111111111000000111111111111111111111111111000
0001111111111111111111111111111110000000111111111111111J11111111111111111000
0001111111111111110111111111111110000000111111111111111111111111111111111000
0001111111111111111111111111111111111111111111111111101111111111111111111000
0000000001111111111111111111111111111111111111111111101111111111111111111000
0000000001111111111111100000011101111111000000000111111111000000001011000000
0000000001111111111111100000001101111111000000000111111110000000001011000000
000000000111111111111110000000110111111100000000000011111P000000001011000000
0000000111111111111111111000001111111111110000000001111111000000011010000000
0000000111111111111111111000011111100001110000000001111111000000011011000000
000000011111110001111111100PP11111100001110000000PP111111111100001101100P000
00000001100011001111000111111110011000011100000011111111111110PP011001111000
0000000110111100111100000111101001100001110000001111111100011111111001111000
0000001110111100111100000111101001111111111111111111111100011111100001000000
0001111100111100111100000000000001111111111111111111111100000011000000000000
0001111000000000011100000000000001111111110000001101111100000001000000000000
0000000000000000001100000000000000000000000000000000111100000000000000000000
0000000000000000001100000000000000000000000000000000111100000000000000000000
0000000000000000001100000000000000000000000000000000111100000000000000000000
0000000000000000001100000000000000000000000000000000111100000000000000000000
0000000000000000001100000000000000000000000000000000111100000000000000000000
0000000000000000001100000000000000000000000000000000111100000000000000000000
0000000001000000001100000000000000000000000000000000111100000000000000000000
0000000001000000001100000000000000000000000000000000111100000000000000000000
00000000000000P0111101100PP01000000PP000000000011110111100010000001000000100
0100000001100010111111111111111111111100000000011110111100110000001000000100
01000000011000111111111111111011111111110000PP011111111111110011101000000100
010PP0111111111111111111111110111110111101101111111111111111111111100PP00100
0111111111111111001110000000000000001100111111110100111100001111111111111100
0101110001100011111111111111110000000000110001111000111100000000111110000100
0100000000000000111100000000000000000001001000000000111100001100001000000100
0100000000000000111100000000000000000010001000000000111100001100000000000100
00000000000100000011110000001100000PP010011000000001111111111111110011101100
011100000001111111110100000010000010001101000000000111111100111J111100001100
0111110PP0011111111100000000110000100011000000000001111111111111110111111100
0110111111111111111100000000111011110000000000000001111110001111111111111100
0110111111111111111100000000000001110000000000000001111110000000011011111100
0000110111100000001100PP000000000111000000PP10000001111111000000011000000100
0111000001100000001101111000000001110000011111110001111111000000011000000100
01111111100000P000110111100000PP0111000P011101111111111111100000011000000100
01100001110001111111111111111111111111111J0000111111111111111011111000000110
0110000111100111111111111111111111111111111111111111111111111111101111111110
0000000111111111110011111111111111111111111111111111101111111111111111111110
0000P00010111111111101111111111111111111111111111111101111111111111111011110
0001100110111000111111111101000011111111111111111111111111101101111111111110
0111100110111000111111100001000011111111111111111111110011100001111111111110
0111111111111000110111100001000011111111111111111111110011100000000111111110
01111111111110P0110011111111000011111111111111000000010001100000000001111110
0111111111101J11110000011111111111101111110000000000011001110000000000001110
011111011000000000000000000011111000001111000000000001111J110000000000000010
0011100000000000000000000000000000000011110000000000000111110000000000000P10
0011100000000000000000000000000000000011110000000000000111110000000000001110
0111000000000000000000000000000000000011110000000000000111110000000000001110
0111000000000000000000000000000000000011110000000000000111110000000000000000
0110000000000000000000000000000000000011110000000000000111110000000000000000
0110000000000000000000000000000000000011110000000000000111110000000000000000
0110000000000000000000000000000000000000000000000000000111110000000000000000
0110000000000000000000000000000000000000000000000000000111110000000000000000
0110000000000000000000000000000000000000000000000000000111110000000000000000
0000000000000000000000000000000000000000000000000000000000000000000000000000
0000000000000000000000000000000000000000000000000000000000000000000000000000
0000000000000000000000000000000000000000000000000000000000000000000000000000
0000000000000000000000000000000000000000000000000000000000000000000000000000
0000000000000000000000000000000000000000000000000000000000000000000000000000
0000000000000000000000000000000000000000000000000000000000000000000000000000
0000000000000000000000000000000000000000000000000000000000000000000000000000
0000000000000000000000000000000000000000000000000000000000000000000000000000
0000000000000000000000000000000000000000000000000000000000000000000000000000
